11111111111111111111111
1010001011000CC00010001
10000000000000000001011
11010011000000001000001
110C00C00C0000C00000001
10101000110011000110101
10C000000000001000$1101
10000101110000E1C000011
100000110C011111$00C001
10000001010P01100000101
11111111111111111111111
