111111111111111111111111111111111111111111
100011000001000000011010101010001000010011
110100010001000010000000000000001000100001
101110100001010000100000100000000100100001
101010000000001000000111000100100000100001
100011000010011000010001001001000000000001
100000000010010000001000001010010000000001
100100000010000011000001010000000001011001
111000001000000110000000001001000100111011
110001110011000011010100000010001000000011
100001100000010000001110001000000000000001
100000000000001110011110011010000011100001
100000100000001001000000010100010000000001
111000001100010001000001000010111111001011
101001001100100100110100100110000010111001
101000100101000010100001000000011001100001
110000000101000000100000000010100100010001
100010000000000000100101100010000000110001
100000000100000000000000001001000000000001
100110000C10000001100001000110000100100C01
10000101000000001100001C000000100001110111
100000011C010100100001101110010000C0000001
11100C110E010C1000101000000110000110001001
100C10000000110C01010$C0000100110101010101
10000000000000011000010000P000001000$$0001
111111111111111111111111111111111111111111
