11111111111111111111111111111111111
11000000010000000010110C01101110101
11000000000100110000001000010000001
10000101000000111011001101010000011
10000011010011000001$00000000101111
10000000000100001000001000000101001
11001000000001000100010100010000001
10100000000000001000001100000001111
101100C0110011101001010000000010001
11000000110001000000000000110000001
10000100000000000001000000001010001
10010010000000010001010010010100C01
10010100100010001000100001010011011
100100000P00C1010011000001100000101
11000100001101000010010001000000001
1110011000C00000000011010000011C001
1101000010000C110100000000010$00001
10000100100000010000101100C01101001
1010011010E000010001001000010000001
10000010101010001000100000001110001
100100000110110000001000C0000000001
10$0010010C011000001000110000101011
10000001100000100100010000000000001
11111111111111111111111111111111111
