111111111111
100010001001
100000100101
110000001001
101010001011
100$10000001
10000000E001
10C011010001
10000C000011
1000001C0101
1010$0001111
110100000C01
1C00C0110011
110000000101
1111011C0011
1P001C00C101
1000000C0001
100100011001
100010010001
111111111111
