11111111111111111111111
10000000010010000000001
100000$0000100010010001
10010000000110010000101
10010101000010010000001
10000111010000001001001
10001000000000100100011
10100000000000010000111
111E01001P0000010000001
10010001000000010010101
1001001C010000001001011
100000C0000010111000001
1000110$000000000000011
11000100000010001010001
10010000100001001010011
110000101010000C0000111
11000100000000100C00001
1011101100C011001010101
11001111011010100000001
10C0C1110001011000011C1
100000000101C00100001C1
10000010000000110000001
11111111111111111111111
