11111111111111111111111
10000000000000101000101
10000000011000000000001
10010000000110011100001
11001000011000000010101
10011000000000100010001
10010100100000010100001
10001110000000011000101
10011000000101000111001
10000100001000100000011
10100010111000100000001
10011000000C01000000001
1C000000C00010000100101
11000000101110000010101
10000011111010001110001
1001C110110000000100001
10101001100000001000001
10000010000011001001001
10000001000110000010001
1C010000000001000010111
10010000001011000C00111
1C0CC001001001000000001
11E10$11001000110111001
1C0P0000001100100000$01
10010001010000000001001
11111111111111111111111
