1111111111111111111111111
1000000001000000010100001
1011100000001000000100011
1000100001000100000000001
1001010000000000000011001
1000000000001000000100011
1000101001000000100101001
1010000100011110001000001
1000101000000000000000111
1100100101000000110111001
1000001000000100010100101
1000001000101011000101011
110000000000010C011000001
1000000000000000000000001
1100000000110011010011001
1000100101110101000101101
10000000001111110100000C1
1000010010100000010101001
1000010000C10000100101001
100000C000001100010000011
1101000001C00001111001001
10C101001000101100P00C011
1CC$001011$E11000C1110101
1010100000000000000000001
1111111111111111111111111
