1111111111111111111111111
1000001101000000000101001
1000000110010000000100001
1010000000010101000000001
1010000000100000000001001
1000001000001000000000001
1000010100000110000010001
1000001001000000001100101
1010010010010001100000001
10000000000100001010C1001
1000100101000111001000001
1100100001000110000110001
1000000001000100001000111
1000010000100000000110001
1001000100100100000010001
1101000001100000100100001
1100100101000000000101001
1100001000100111100000001
1100010100C10010010000001
1001100000000001111000101
1001100101010010100010111
1100100000000000101001011
1000001100000000011101001
101C1000010000000001000C1
100C110CC0111101100010011
100P101001001101CCE01C011
1000100001000000010000001
1111111111111111111111111
