11111111111
1C100100011
10P10000001
10000000011
11100110101
10011000011
100100000$1
10001000111
11001010011
10000010011
1000$00CC01
1001E001001
100C0C00001
10100111001
101011011C1
10C01C00001
1C100001101
100000C0001
10000000101
10000000001
11111111111
