11111111111111111111111
10100000010010000000101
11100000001100000000001
10000000000101000100001
10000000000000000000001
10101001000010000011001
101010000C1111010000001
1011010000000C100000001
10001000010100110100011
10010010001100001000001
10100010100000000110001
10000000000101011010111
11000000010011010001111
11011111000000010000101
11000000010100011100101
10000100000001001011001
110000001C0011100100001
100000CEC11000001000001
11000001000000100CCC101
110101011$$100C00P00001
100000010000000C0000011
11111111111111111111111
