11111111111111111111111111
10000001000000000010100001
11000000000001000000001001
10001000000100100000000011
10000000000100100001000001
10000010000000000000010001
11000110000000000001000001
10000000101001000110000001
11010000001111000000001001
100000010000000001E0000011
10000000000000100001000001
10000001000000000000100001
10000000111000000010000011
10000000000000100000000001
10000000001010000110000001
11010000000000000000001001
10000000010000000100000001
1010000101000000000100C001
1001001010000001000100C011
10000110101010101001000111
10000000001000000000000011
10000100000011010000100001
1100000010000000010000C001
10CCCC10111000000010111001
1P00100010$$C00CC001001001
10000010000000000001000001
11111111111111111111111111
