11111111111111111
10000001000100001
11000001010010001
10100000100000001
10011011100000011
10010100001000101
11000100000001001
1000000100C110001
1E000010100000011
11000000110000001
10000111000000011
10000001000000011
10111000010000101
111001011001C1001
10000000011010001
10010000010001011
110111CCC01000001
10101C0C11C100101
1000P000010000C01
10000000C00000001
11111111111111111
