111111111111
100000010011
100101011001
100001010001
10100000C011
100010011011
100100001011
100000C1C001
101000$01001
101000010001
100000101001
1C0000010001
100101000001
1100101011C1
100011001001
1CC0C000CE11
1100100C0011
10000110$001
100100000P01
100100000001
111111111111
