11111111111111111111111
10010000000000010000001
10001000000000000000001
10000011000000000000101
10000000010000100010001
10000100100000000000011
10000000000000000001101
10000000001000000001101
10001000011000001000011
10100001000001000100001
10100000000000000100011
10000000000001001010001
10011001000000001101001
10000000101000000001101
10100100100010000000101
11001001000000000101101
10100100100000000000001
11001000000000000000001
10010010000000000000001
10000011100000000000011
10101101000010010000011
10001000001000000000001
10010001000000001000101
10000000000000000010001
10000000000010000000101
10001010000100000000001
10010000000000100000001
10001010000011010000001
10001000100000000100011
10000001101000001010011
10000101000100000000001
10000000000000000000001
10000100000000010000011
10001100100010010000101
10011010100000001001001
10000000010000000010001
11000010000000001010101
10000000100010001000001
1C100000000010000001001
10000100100111011000P01
1001010C00001E100111001
110000000$$0000000C0001
10000000010000000000001
10000000000000010010001
11111111111111111111111
