111111111111111111111111111111111111111111111111111111111111111111111111111111111111111111111111111111111111111111111111111111111111111111111111111111111111111111111111111111111111111111111111111111111111111111111111111111111111111111111111111111111111111111111111111111111111111111111111111111111111111111111111111111111111
100000000000001000001000010000000001000000000000000000000100000001100011000000000000100000100010000100010000001000100010100000010000101001010100000000000101100001000000000000000000010010000000000001100100000000010010000000101000000000000000000000000000001001000000000000000010000000000000000100000000000000000000000000000001
100000000000001000010000011011100000000010000000000000100110100000000010000000100100001010000100001001000000001000000000000000000010001000000000000000100000000100001000000001000010000000001010000000001000010000000000100000000001000000001001000000010000100001000000000000001010000000000010001100010000100000000010001100000001
100000011000100000001000000000110001000000000000000100000000011000000000010001110000101000000010000101100000100000000000000000000000000000100000100100000000000000000000000000000000000000100110100000000000010000000010000001000110000000100000000001000000000000001101000000100001000010000000000000000001000100101010000000100001
100010000010000001000001001000000000000000001010000000000101000100010000110101000000000001000111100000000000010001000000000001000000000100011001001111000000011010000001000000000000100000000000000000000010000000000101000000000010100000000100001000100000000100100000000000100000000000000101000000100100010000000000010000000001
100000001110000100100000000000010000000001100011000000000000000010100000100010000000000101001000000000100001000110000000000000000101000000010000000000000000000000000010010001110000000000000000000000100000111000100010100010000000000110000000101010100000000110010100001000001000001000000000010100000100000000000010010000000101
100000000000000001000000010000001101000000010000100100001000010010000010000001100000100000010101000000000000000011001000000000000001000100000001000011010010100000000001000100010001010000101000010001010000001010000000000010000001000000000000100001010100010000100000000110000000101000100001000000100000000000000010010000001001
100000001000000000101000000111001000000011000010000000100000000001101000000110000010000000101001000011000000101000010111101001110001000000100000010000110000000000000000000000001010010010000010010000110000110100000100000000000000010100001000010000100000000001111100000000000100000010010110000001000000110001000000010000110001
1100000010100000100101000001100000000100000000001010010000000001000000001000001100001001001000010000000100000$0000000000000000111010100000001000000000000001001010000100001000000000101001010101000010000011000000000001010010000000001010100010100000001000000000000000000000000001100100100000000000000000000000011000011000000001
1000000000E0110000000010010100100000010010000000010000001000000010100000000000010110000011000100001000000000000000010001000000000000000001000000000000000000000000000000000011010001001001100000001011010110010000010000010000000000100010001000000000000000000010000000010000000000000000000001000000001110000000100100100000000001
100100000001101010000001000000000010010000000010001000000100000000000100001000000000001000000010110000C00000000000001000100000000000001101000010P00100000000001000010000C$00100000000000000100010010010000100000001100000001000000011C0000001000000001010000000000000001000000000000000000000000010000000110100110011000001000000001
111111111111111111111111111111111111111111111111111111111111111111111111111111111111111111111111111111111111111111111111111111111111111111111111111111111111111111111111111111111111111111111111111111111111111111111111111111111111111111111111111111111111111111111111111111111111111111111111111111111111111111111111111111111111
