111111111111111111
100001001010000001
101011000010100001
100001000000000001
100000000000000001
100110000000100001
100000010001000001
100000000100000001
100010000001000001
100000001010000001
100001000000000111
11000C100010000001
100000101010001111
100000100000000001
101000000010000011
10C11000E$1C111001
1P0000000100000001
100010000010000001
111111111111111111
