1111111111111111111111
1010001100000010000001
1000001000000000001001
1000000000100010000011
1000000001000000000001
1000000000001000010101
1110000100001100000101
1001000000100000000001
1000000000000000000001
1100000100100100010001
1111111111111111111111
