111111111111111111111
100000000000000000001
100000000000000000001
101000000101100000001
100000000000000000001
100000100000000000001
100010000110000100001
100000010010000101001
101000000000000000001
110010101000000000101
100010101000000001001
100101000000110000001
111000000000100100001
100000000101000000001
100000100000101001001
101011000011010000111
100000001100010100001
100001010000000100001
100010000000000111001
100000000100100010001
110000000001100000101
100000001010000000001
100000C00000000100011
110010E0C001000000C01
100010110100000000001
101110000001010100001
100000000000000001101
100010C000C10C0010001
1C011C0CC001100001011
10000000001P000000001
100000000000000000001
111111111111111111111
