11111111
11100011
10000101
11000001
10000001
10000001
10100001
10000001
10001001
10000001
10000C01
11000001
10010001
10010101
10000001
10001011
11100101
10100001
11100001
10000001
1C100011
11000001
10001011
10010011
10000001
100001$1
10000001
10000001
10000001
111101C1
11000001
11$00011
11E00CC1
110C0101
1C100CC1
100C0001
10000001
1000P011
10000001
10000001
10000001
10000001
10000001
11111111
