111111111111111111111111111111
110101100000100000100100000101
100010000000001000000001000101
101010010001000100110000011001
110000000100110000000000100111
110000001100001010001010001101
100100100010000010000000000011
110010000000000000000000000001
110100000100000000000C00000001
100000100001000000000000001001
100010001111100001001000100011
100001000100100100010000001101
110100011000010100000010010001
110000011011010011111000000101
111001000000011010000000000011
100001110101001C00110C01000111
100000010000000000010010111001
101000000000000110000000000101
11010C011100001001001001000111
10000101100101C011010101101001
100000000101000011000000000001
10001000010001000000100000CC01
100110001001000010000000010101
100000000001110000001000001001
100010000000000001001010110001
100001100000001000000001001001
11000111100000000101000000P111
11010000000C00000E0C11C1000101
110000000101100010001010100001
111111111111111111111111111111
