1111111111111111111111111111
1000010000000000001010001001
1000011000001001000011000111
1100000000010100000010001011
101000000000000P000000101001
1100000000001000000001000001
1110001000001000000000101101
1000100000010000000100000001
1100000000000000100010000001
1010100000000100000000000011
1100000100100000010001001001
1000001000000000110000C00001
1001000000000000010000000001
1100000000100010000000000101
1000000000001000000000000101
1000000100001000000010000011
1000110000000000010100000001
1100000000000000000100000001
1000100100000001000000000001
1001000000000000000001000001
1000011110000010000110000001
1110001000000001010000010001
1000000000000000100001100001
1000010000100001000100111101
1000001010000000000000001001
1101011000C0C100001000000111
1010010000100000000010000001
100CCC000110000001E010111001
100000000100$$C000C0C000C001
1000000000100100000000000011
1111111111111111111111111111
