111010010101010010101111010010101010010101111010010101010010101111010010101010010101
111111111110100101010100101011110100101010100101011110100101010100101011110100101010
1000