1111111111111111111111111111
1CCCCCCCCCCCC11CCCCCCCCCCCC1
1C1111C11111C11C11111C1111C1
1C1111C11111C11C11111C1111C1
1CCCCCCCCCCCC11CCCCCCCCCCCC1
1C111101000000000000101111C1
1C1CC0010001111110001000C1C1
1C1C10010000011000001001C1C1
1CCC10011110011001111001CCC1
11111001CCCCCCCCCCCC10011111
111110010011100111CC10011111
1111100101000000001C10011111
1C00000001111001111CC00000C1
1C00000CCCCCCCCCCCCCCCC000C1
1111100101111111111010011111
1111100CCCCCC11CCCCCCCC11111
1111100111100110011110011111
1CCCCCCCCCCCCCCCCCCCCCCCCCC1
1C1111C1C1111111111C1C1111C1
1CCCC1C1C1CCC11CCC1C1C1CCCC1
111CCCC1CCC1C11C1CCC1CCCC111
1P0011111111CCCC1111111100E1
1000CCCCCCCCCCCCCCCCCCCC0001
1111111111111111111111111111